Credits:

Credits for Pokemon Essentials

Sprites for gens 3-5: MrGagula (get location)

Tutorials: Thundaga (Youtube)

All Asian style buildings in Kanazawa City: PeekyChew (DeviantArt)

Custom colored text: VanillaSunshine (RelicCastle.com)

Boss Cyrus Overworld and Battle sprite: PurpleZaffre (DeviantArt)

Lots of Trainer Overworld/Battle sprites and Galandart Battle Sprites: Geroisblackboots (DeviantArt)

Detective Looker Battle Sprite: WillowWhips (Deviant Art)

Jessie and James Overworld sprites: Kalarie (PokeCommunity.com)

Jessie and James battle Sprites: Kimba616 (DeviantArt)

Snowy tileset, buildings, and cliffs used on Route 12 and various other places: Wesley FG (PokeCommunity.com)

Pokemon Diamond/Pearl Tileset: ThePokemonChronicles (DeviantArt)

Wondertrade Script: Black Eternity and Mej71 (PokeCommunity.com)

Music:
Most Music: khinsider.com (Get credits for Nintendo music / HxH music if used)
Darkrai, Celebi, Latios/Latias, and more battle themes: Lala19357 - The Zephyr (Youtube)
Vladamir Battle Music: Owen Dennis (OG composer) | Ruisu River (Remix)
Dark Cynthia Theme: hnturs12 (Youtube)
Battle Colosseum Final Theme: Freedom Dive by xi
Cyrus Battle Theme remix and Shadow Triad Intro: Zame (Youtube)
Snowpoint City remaster: Zame and Pokestir on youtube (not used yet)
Champion Battle Theme: VanilluxePavilion (Youtube)
Russia Grunt Theme: EternalSushi, ElectricMudkip, and Kamex (Youtube)
Russian Admin Theme: EternalSushi and emdasche (Youtube)
Galandart Battle Theme: Licht und Schatten by Yutaka Yamada
Deoxys Battle Theme: Get credits for Carter's song

Include credits for elite battle system

Script for AI using revivial items: Poq (Relic Castle)

Battle sprites for gens 4-5 trainers: Mr. Gela (Relic Castle)

Gen 4 Overworld Character Sprites: Neo-Spriteman, Vanilla Sunshine, PurpleZaffre & Maicerochico, AtomicReactor (get location)


Lots of Overworld Sprites from Gens 4/5/6 including Zinnia, Alder, Flint, and many more: aveontrainer (Deviant Art)

Zinnia battle sprite: officialthatguy (Deviant Art)

Silver Overworld Sprite: Skeizerr (Deviant Art)

Burglar Overworld Sprite: sphericalice (Deviant Art)

Cyclist Overworld Sprites: Teraneck (Deviant Art)

Overworld Sprites for Doyen Trainers: Mashirosakura (Relic Castle)

Zinnia Tent: RBRNNova (Deviant Art)

Heavenly Pillar Top Map: Clara-Dragon (Deviant Art)

Fortree City tree houses: TheDeadHeroAlistair (Deviant Art)